    11111111
   1        1
  1          1
 1            1
1              1
1              1
1              1
1              1
1              1