0000111111110000
0001000000001000
0010000000000100
0100000000000010
1000000000000001
1000000000000001
1000000000000001
1000000000000001
1000000000000001