1111111111111111
1222222222222221
1 111111111111 1
1 1          1 1
1 1 11 11111   1
1 1 12     11111
1 1 1 1111 1 1 1
1 1 1 1  1 1 1 1
1 111 1      121
1 121 11 1 1 1 1
1 1 1      1   1
1 1 11111111 1 1
1            1 1
1 1111111  111 1
1 1            1
1111111111111111