111111111111111111111111111111111111
11111111111           11111111     1
11     1          111          1 1 1
1                                  1
1                                  1
1                                  1
1                                  1
1                                  1
1                                  1
1                                  1
1                                  1
1                                  1
1                                  1
1                                  1